#####################################
#.      # #.#    .    . #   #     # #
# ####### # ### # ### ### ####### # #
#     . #       # #     #     # #   #
##### ##### ### # # # ### ##### # ###
#   # # # #   # # # #   # #   # #   #
# ### # # # ### ##### ### # ### ### #
#       #.    #   #  .#     # # #   #
### ######### ####### ### ### # # # #
#             #       # #   #     # #
# # ##### # ### # # ### # ### ### # #
# # #   . # # # # #     #   # # # # #
# # # ####### # ######### ### # ### #
# # # #     #   #     #     #   #   #
### ### # ##### ##### ### ### ##### #
#   . # # #     # #     # #   # # # #
# # # # # ### ### ### ### # # # # # #
# # # # #                 # # #     #
### ####### # # ##### ### # ### #####
#       #.# # #     #   #     # #   #
##### # # ######### ########### # ###
#   # #           # #     #   # #   #
# ### ##### ######### ##### # # ### #
# #   #  .   #        #     #       #
# # # ##### ### # # # # #############
# # #   #     # # # #    .  #   # # #
# # ### ### # # # ######### ### # # #
# #   # #   # # #   # #   # # #     #
# ### ### ##### ### # # ##### # #####
#       #   #     # #     #   # #   #
### # ##### ##### ### ### # ### # ###
# # # # # #.# #.    # #   # #   # # #
# # ### # # # # #########.# # # # # #
#   #   #   #                 #     #
# # # # ### ### ####### ### ### ### #
# # # #       #   #       #   # #  P#
#####################################