#####################################
#       # # #           #   #     # #
# ####### # ### # ### ### ####### # #
#       #       # #     #     # #   #
##### ##### ### # # # ### ##### # ###
#   # # # #   # # # #   # #   # #   #
# ### # # # ### ##### ### # ### ### #
#       #     #   #   #     # # #   #
### ######### ####### ### ### # # # #
#             #       # #   #     # #
# # ##### # ### # # ### # ### ### # #
# # #     # # # # #     #   # # # # #
# # # ####### # ######### ### # ### #
# # # #     #   #     #     #   #   #
### ### # ##### ##### ### ### ##### #
#     # # #     # #     # #   # # # #
# # # # # ### ### ### ### # # # # # #
# # # # #                 # # #     #
### ####### # # ##### ### # ### #####
#       # # # #     #   #     # #   #
##### # # ######### ########### # ###
#   # #           # #     #   # #   #
# ### ##### ######### ##### # # ### #
# #   #      #        #     #       #
# # # ##### ### # # # # #############
# # #   #     # # # #       #   # # #
# # ### ### # # # ######### ### # # #
# #   # #   # # #   # #   # # #     #
# ### ### ##### ### # # ##### # #####
#       #   #     # #     #   # #   #
### # ##### ##### ### ### # ### # ###
# # # # # # # #     # #   # #   # # #
# # ### # # # # ######### # # # # # #
#   #   #   #                 #     #
# # # # ### ### ####### ### ### ### #
#.# # #       #   #       #   # #  P#
#####################################