#####################################
#.      #                         #.#
#         ##### # ### ### ####### # #
#       #       # #     #     # #   #
##### ##### ### # # # ### ##### # ###
#   # # # #   # # # #   # #     #   #
# ### # # # ### ##### ### # ### ### #
#       #     #   #   #     # # #   #
### ######### ####### ### ### # # # #
#             #       # #   #     # #
# # ##### # ### # # ### # ### ### # #
# # #     # # # # #     #   # # # # #
# # # ####### # ######### ### # ### #
# # # #     #   #     #     #   #   #
### ### # ##### ##### ### ### ##### #
#     # #               # #   # # # #
# # # # #  #  ### ### ### # # # # # #
# # # # # ##  # # # # #   # # #     #
# # #####  #  ### ### # ### ### #####
#       #  #  # # # # #       # #   #
# ### # #  #  ### ### ######### # ###
#   # #         1         #   # #   #
# ### ##################### # # ### #
# #                         #       #
# # # ##### ### # # # # #############
# # #   #     # # # #       #   # # #
# # ### ### # # # ######### ### # # #
# #   # #   # # #P  # #   # # #     #
# ### ### ### # ### # # ##### # #####
#       #   #     #       #   # #   #
### # ##### ##### ### ### # ### # ###
# # # # # # # #     # #   # #   # # #
# # ### # # # # ######### # # # # # #
#       #                     #     #
# #   # ### ### ####### ### ### ### #
#.#   #       #           #     #  .#
#####################################