####################
#o...#........#....#
#.##.#.######.#.##.#
#.#..............#.#
#.#.##.##  ##.##.#.#
#......#1  2#......#
#.#.##.######.##.#.#
#.#..............#.#
#.##.#.######.#.##.#
#....#...P....#...o#
####################
