#######
#  P  #
#     #
#     #
#  G  #
#     #
#######