#######
#    P#
# ### #
#  #  #
##   ##
#. ####
#######
